111111111111111111111111111111111111111111111111111111111111111111111111111111111111111111111111111111
111111111111111111111111111111111111111111111111111111111111111111111111111111111111111111111111111111
111111111111111111111111111111111111111111111111111111111111111111111111111111111111111111111111111111
111111111111111111111111111111111111111111111111111111111111111111111111111111111111111111111111111111
111111111111111111111111111111111111111111111111111111111111111111111111111111111111111111111111111111
111111111111111111111111111111111111111111111111111111111111111111111111111111111111111111111111111111
111111111111111111111111111111111111111111111111111111111111111111111111111111111111111111111111111111
111111111111111111111111111111111111111111111111111111111111111111111111111111111111111111111111111111
111111111111111111111111111111111111111110000000000000000000011111111111111111111111111111111111111111
1111111111111111111111111111111111111111100000000SHoP0000000011111111111111111111111111111111111111111
111111111111111111111111111111111111111110000000000000000000011111111111111111111111111111111111111111
11111111111111111111111111111111111111111000000000s000000000000000000000000000000000000000000000000021
111111111111111111111111111111111111111110000000000000000000000000000000000000000000000000000000000021
111111111111111111111111111111111111111110000000000000000000000000000000000000000000000000000000000021
111111111111111111111111111111111111111110000000000000000000000000000000000000000000000000000000000021
111111111111111111111111111111111111111110000000000000000000000000000000000000000000000000000000000021
111111111111111111111111111111111111111110000000000000000000000000000000000000000000000000000000000021
111111111111111111111111111111111111111110000000000000000000000000000000000000000000000000000000000021
111111111111111111111111111111111111111110000000000000000000000000000000000000000000000000000000000021
111111111111111111111111111111111111111110000000000000000000000000000000000000000000000000000000000021
111111111111111111111111111111111111111110000000000000000000011111111111111111111111111111111111111111
111111111111111111111111111111111111111110000000000000000000011111111111111111111111111111111111111111
111111111111111111111111111111111111111110000000000000000000011111111111111111111111111111111111111111
111111111111111111111111111111111111111111111111111111111111111111111111111111111111111111111111111111
111111111111111111111111111111111111111111111111111111111111111111111111111111111111111111111111111111
111111111111111111111111111111111111111111111111111111111111111111111111111111111111111111111111111111
111111111111111111111111111111111111111111111111111111111111111111111111111111111111111111111111111111
111111111111111111111111111111111111111111111111111111111111111111111111111111111111111111111111111111
111111111111111111111111111111111111111111111111111111111111111111111111111111111111111111111111111111
111111111111111111111111111111111111111111111111111111111111111111111111111111111111111111111111111111
111111111111111111111111111111111111111111111111111111111111111111111111111111111111111111111111111111
111111111111111111111111111111111111111111111111111111111111111111111111111111111111111111111111111111