111111111111111111111111111111111111111111111111111111111111111111111111111111111111111111111111111111
111111111111111111111111111111111111111111000000QUEST000000111111111111111111111111111111111111111111
111111111111111111111111111111111111111111000000000O00000000111111111111111111111111111111111111111111
111111111111111111111111111111111111111111000000000000000000111111111111111111111111111111111111111111
111111111111111111111111111111111111111111000000000000000000111111111111111111111111111111111111111111
111111111111111111111111111111111111111111000000000000000000111111111111111111111111111111111111111111
111111111111111111111111111111111111111111000000000000000000111111111111111111111111111111111111111111
111111111111111111111111111111111111111111000000000000000000111111111111111111111111111111111111111111
111111111111111111111111111111111111111111000000000000000000111111111111111111111111111111111111111111
111111111111111111111111111111111111111111000000000000000000111111111111111111111111111111111111111111
111111111111111111111111111111111111111111000000000000000000111111111111111111111111111111111111111111
111111111111111111111111111111111111111111000000000000000000111111111111111111111111111111111111111111
100000000000000000000000000000000000000000000000000000000000000000000000000000000000000000000000000021
100000000000000000000000000000000000000000000000000000000000000000000000000000000000000000000000000021
100S00000000000000000000000000000000000000000000000000000000000000000000000000000000000000000000000021
100H00s00000000000000000000000000000000000000000000000000000000000000000000000000000000000000000000021
100o00000000000000000000000000000000000000000000000000000000000000000000000000000000000000000000000021
100P00000000000000000000000000000000000000000000000000000000000000000000000000000000000000000000000021
100000000000000000000000000000000000000000000000000000000000000000000000000000000000000000000000000021
100000000000000000000000000000000000000000000000000000000000000000000000000000000000000000000000000021
111111111111111111111111111111111111111111000000000000000000111111111111111111111111111111111111111111
111111111111111111111111111111111111111111000000000000000000111111111111111111111111111111111111111111
111111111111111111111111111111111111111111000000000000000000111111111111111111111111111111111111111111
111111111111111111111111111111111111111111000000000000000000111111111111111111111111111111111111111111
111111111111111111111111111111111111111111000000000000000000111111111111111111111111111111111111111111
111111111111111111111111111111111111111111000000000000000000111111111111111111111111111111111111111111
111111111111111111111111111111111111111111000000000000000000111111111111111111111111111111111111111111
111111111111111111111111111111111111111111000000000000000000111111111111111111111111111111111111111111
111111111111111111111111111111111111111111000000000000000000111111111111111111111111111111111111111111
111111111111111111111111111111111111111111000000000000000000111111111111111111111111111111111111111111
111111111111111111111111111111111111111111000000000000000000111111111111111111111111111111111111111111
111111111111111111111111111111111111111111111111111111111111111111111111111111111111111111111111111111