111111111111111111111111111111111111111111111111111111111111111111111111111111111111111111111111111111
111111111111111111111111111111111111111111000000000000000000111111111111111111111111111111111111111111
111111111111111111111111111111111111111111000000000000000000111111111111111111111111111111111111111111
111111111111111111111111111111111111111111000000000000000000111111111111111111111111111111111111111111
111111111111111111111111111111111111111111000000000000000000111111111111111111111111111111111111111111
111111111111111111111111111111111111111111000000000000000000111111111111111111111111111111111111111111
111111111111111111111111111111111111111111000000000000000000111111111111111111111111111111111111111111
111111111111111111111111111111111111111111000000000000000000111111111111111111111111111111111111111111
111111111111111111111111111111111111111111000000000000000000111111111111111111111111111111111111111111
111111111111111111111111111111111111111111000000000000000000111111111111111111111111111111111111111111
111111111111111111111111111111111111111111000000000000000000111111111111111111111111111111111111111111
111111111111111111111111111111111111111111000000000000000000111111111111111111111111111111111111111111
100000000000000000000000000000000000000000000000000000000000000000000000000000000000000000000000000021
100000000000000000000000000000000000000000000000000000000000000000000000000000000000000000000000000021
100000000000000000000000000000000000000000000000000000000000000000000000000000000000000000000000000021
100000000000000000000000000000000000000000000000000000000000000000000000000000000000000000000000000021
100000000000000000000000000000000000000000000000000000000000000000000000000000000000000000000000000021
100000000000000000000000000000000000000000000000000000000000000000000000000000000000000000000000000021
100000000000000000000000000000000000000000000000000000000000000000000000000000000000000000000000000021
100000000000000000000000000000000000000000000000000000000000000000000000000000000000000000000000000021
111111111111111111111111111111111111111111000000000000000000111111111111111111111111111111111111111111
111111111111111111111111111111111111111111000000000000000000111111111111111111111111111111111111111111
111111111111111111111111111111111111111111000000000000000000111111111111111111111111111111111111111111
111111111111111111111111111111111111111111000000000000000000111111111111111111111111111111111111111111
111111111111111111111111111111111111111111000000000000000000111111111111111111111111111111111111111111
111111111111111111111111111111111111111111000000000000000000111111111111111111111111111111111111111111
111111111111111111111111111111111111111111000000000000000000111111111111111111111111111111111111111111
111111111111111111111111111111111111111111000000000000000000111111111111111111111111111111111111111111
111111111111111111111111111111111111111111000000000000000000111111111111111111111111111111111111111111
111111111111111111111111111111111111111111000000000000000000111111111111111111111111111111111111111111
111111111111111111111111111111111111111111000000000000000000111111111111111111111111111111111111111111
111111111111111111111111111111111111111111111111111111111111111111111111111111111111111111111111111111