111111111111111111111111111111111111111111111111111111111111111111111111111111111111111111111111111111
100000000000000000000000000000000000000000000000000000000000000000000000000000000000000000000000000001
100000000000000000000000000000000000000000000000000000000000000000000000000000000000000000000000000001
100000000000000000000000000000000000000000000000000000000000000000000000000000000000000000000000000001
100000000000000000000000000000000000000000000000000000000000000000000000000000000000000000000000000001
100000000000000000000000000000000000000000000000000000000000000000000000000000000000000000000000000001
100000000000000000000000000000000000000000000000000000000000000000000000000000000000000000000000000001
100000000000000000000000000000000000000000000000000000000000000000000000000000000000000000000000000001
100000000000000000000000000000000000000000000000000000000000000000000000000000000000000000000000000001
100000000000000000000000000000000000000000000000000000000000000000000000000000000000000000000000000001
100000000000000000000000000000000000000000000000000000000000000000000000000000000000000000000000000001
111111111111111111111111111111111111111111111111111111111111111111111111111111111111111111111111111111
130000000000000000000000000000000000000000000000000000000000000000000000000000000000000000000000000021
130000000000000000000000000000000000000000000000000000000000000000000000000000000000000000000000000021
130000000000000000000000000000000000000000000000000000000000000000000000000000000000000000000000000021
130000000000000000000000000000000000000000000000000000000000000000000000000000000000000000000000000021
130000000000000000000000000000000000000000000000000000000000000000000000000000000000000000000000000021
130000000000000000000000000000000000000000000000000000000000000000000000000000000000000000000000000021
130000000000000000000000000000000000000000000000000000000000000000000000000000000000000000000000000021
130000000000000000000000000000000000000000000000000000000000000000000000000000000000000000000000000021
111111111111111111111111111111111111000000000011111111111111111111111111111111110111111111111111111111
100000000000000000000000000000000000000000000000000000000000000000000000000000010100000000000000000001
100000000000000000000000000000000000000000000000000000000000000000000000000000010101111111111111111101
100000444444444444444444444444444444444444444444444444444444444444444444440000010101000000000000000101
100000444444444444444444444444444444444444444444444444444444444444444444440000010101011111111111110101
100000444444444444444444444444444444444444444444444444444444444444444444440000010101011111111111110101
100000444444444444444444444444444444444444444444444444444444444444444444440000010101c0000000000T110101
100000444444444444444444444444444444444444444444444444444444444444444444440000010101111111111111110101
1000004444444444444444444444444444444444444444444444444444444444444444444400000101b0000000000000000101
100000000000000000000000000000000000000000000000000000000000000000000000000000010111111111111111111101
10000000000000000000000000000000000000000000000000000000000000000000000000000001a000000000000000000001
111111111111111111111111111111111111111111111111111111111111111111111111111111111111111111111111111111
100000000100000000020000000003000000000400000000050000000006000000000700000000080000000009000000001001