111111111111111111111111111111111111111111111111111111111111111111111111111111111111111111111111111111
100000000000000000000000000000000000000000000000000000000000000000000000000000000000000000000000000001
100000000000000000000000000000000000000000000000000000000000000000000000000000000000000000000000000001
100555555555555555555555555555555555555555555555555555555555555555555555555555555555555555555555555001
100555555555555555555555555555555555555555555555555555555555555555555555555555555555555555555555555001
100555555555555555555555555555555555555555555555555555555555555555555555555555555555555555555555555001
100555555555555555555555555555555555555555555555555555555555555555555555555555555555555555555555555001
100555555555555555555555555555555555555555555555555555555555555555555555555555555555555555555555555001
100555555555555555555555555555555555555555555555555555555555555555555555555555555555555555555555555001
100555555555555555555555555555555555555555555555555555555555555555555555555555555555555555555555555001
100000000000000000000000000000000000000000000000000000000000000000000000000000000000000000000000000001
111111111111111100000000000000000000011111111111111111111111111111111111111111111111111111111111111111
130000000000000000000000000000000000000000000000000000000000000000000000000000000000000000000000000021
130000000000000000000000000000000000000000000000000000000000000000000000000000000000000000000000000021
130000000000000000000000000000000000000000000000011111000000000000000000000000000000000000000000000021
130000000000000000000000000000000000000000000000011111000000000000000000000000000000000000000000000021
130000000000000000000000000000000000000000000000011111000000000000000000000000000000000000000000000021
130000000000000000000000000000000000000000000000000000000000000000000000000000000000000000000000000021
130000000000000000000000000000000000000000000000000000000000000000000000000000000000000000000000000021
130000000000000000000000000000000000000000000000000000000000000000000000000000000000000000000000000021
11111111111111111111111111111111111100000000001111111111111111111111111111111111a111111111111111111111
100000000000000000000000000000000000000000000000000000000000000000000000000000010000000000000000000001
100000000000000000000000000000000000000000000000000000000000000000000000000000010000000000000000000001
100000444444444444444444444444444444444444444444444444444444444444444444440000010000000000000000000001
100000444444444444444444444444444444444444444444444444444444444444444444440000010000000000000000000001
100000444444444444444444444444444444444444444444444444444444444444444444440000010000000000000000000001
100000444444444444444444444444444444444444444444444444444444444444444444440000010000000000000000000001
100000444444444444444444444444444444444444444444444444444444444444444444440000010000000000000000000001
100000444444444444444444444444444444444444444444444444444444444444444444440000010000000000000000000001
100000000000000000000000000000000000000000000000000000000000000000000000000000010000000000000000000001
1000000000000000000000000000000000000000000000000000000000000000000000000000000100000000000000000000T1
111111111111111111111111111111111111111111111111111111111111111111111111111111111111111111111111111111
100000000100000000020000000003000000000400000000050000000006000000000700000000080000000009000000001001