111111111111111111111111111111111111111111111111111111111111111111111111111111111111111111111111111111
100000000000000000000000000000000000000000000000000000000000000000000000000000000000000000000000000001
100000LAST BOSS000000000000000000000000000000000000000000000000000000000000000000000000000000000000001
100000000000000000000000000000000000000000000000000000000000000000000000000000000000000000000000000001
100000000000000000000000000000000000000000000000000000000000000000000000000000000000000000000000000001
100000000000000000000000000000000000000000000000000000000000000000000000000000000000000000000000000001
100000000000000000000000000000000000000000000000000000000000000000000000000000000000000000000000000001
100000000000000000000000000000000000000000000000000000000000000000000000000000000000000000000000000001
100000000000000000000000000000000000000000000000000000000000000000000000000000000000000000000000000001
100000000000000000000000000000000000000000000000000000000000000000000000000000000000000000000000000001
111111111111111111111111111111111111111111111111111000000000000000000000000000000000000000000000000001
130000000000000000000000000000000000000000000000001000000000000000000000000000000000000000000000000001
130000000000000000000000000000000000000000000000001000000000000000000000000000000000000000000000000001
130000000000000000000000000000000000000000000000001000000000000000000000000000000000000000000000000001
130000000000000000000000000000000000000000000000001000000000000000000000000000000000000000000000000001
130000000000000000000000000000000000000000000000001000000000000000000000000000000000000000000000000001
1300000000000000000000000000000000000000B0000000001000000000000000000000000000000000000000000000000001
130000000000000000000000000000000000000000000000001000000000000000000000000000000000000000000000000001
130000000000000000000000000000000000000000000000001000000000000000000000000000000000000000000000000001
130000000000000000000000000000000000000000000000001000000000000000000000000000000000000000000000000001
130000000000000000000000000000000000000000000000001000000000000000000000000000000000000000000000000001
111111111111111111111111111111111111111111111111111000000000000000000000000000000000000000000000000001
100000000000000000000000000000000000000000000000000000000000000000000000000000000000000000000000000001
100000000000000000000000000000000000000000000000000000000000000000000000000000000000000000000000000001
100000000000000000000000000000000000000000000000000000000000000000000000000000000000000000000000000001
100000000000000000000000000000000000000000000000000000000000000000000000000000000000000000000000000001
100000000000000000000000000000000000000000000000000000000000000000000000000000000000000000000000000001
100000000000000000000000000000000000000000000000000000000000000000000000000000000000000000000000000001
100000000000000000000000000000000000000000000000000000000000000000000000000000000000000000000000000001
100000000000000000000000000000000000000000000000000000000000000000000000000000000000000000000000000001
100000000000000000000000000000000000000000000000000000000000000000000000000000000000000000000000000001
111111111111111111111111111111111111111111111111111111111111111111111111111111111111111111111111111111
100000000100000000020000000003000000000400000000050000000006000000000700000000080000000009000000001001